+-+-+-+-+-+-+-+-+-+-+-+-+-+-+-+-+-+-+-+-+-+-+-+-+-+-+-+-+-+-+-+-+-+-+-+-+-+-+-+-+-+-+-+-+-+-+-+-+-+-+
S     |   |   |       |     |   |   |               |                   |       |             |     |
+ +-+ + + +-+ + +-+-+ +-+ + + + +-+ + +-+-+-+-+ +-+ + +-+-+-+-+-+-+-+-+ +-+-+ + +-+-+-+-+-+-+ + +-+ +
|   | | |   | |     | |   |   |     |     | |   |     | |   |       |   |     | |   |     |   | |   |
+-+ +-+ +-+ + + +-+ + + +-+-+-+ +-+-+-+-+ + + +-+-+-+-+ + + + +-+ + + +-+ +-+-+ + + +-+-+ + +-+ + +-+
| |     |   |   | | |   |   |   |         | | |     | |   |   |   | |     |   | | |   |   |     |   |
+ +-+-+-+ + +-+-+ + +-+-+ +-+ +-+-+ +-+-+-+ + +-+-+ + + +-+-+-+ +-+-+-+-+-+ +-+ + +-+ +-+ +-+ + +-+ +
|   | |   | |     |     |     |   |   |   |       | |   |     |             |   | |     |     | |   |
+ + + + +-+-+ +-+-+-+-+ +-+-+-+ + +-+ + + +-+ + + + +-+-+ +-+ +-+-+-+-+-+ +-+ + + + +-+ + +-+-+ + +-+
| |   | |           |   |   |   | |   | |   | | | | |     | |     | |   | |   |   | |   | |   | |   |
+ +-+ + + +-+-+-+-+-+ +-+ + +-+-+ + +-+-+-+ + + + + + +-+-+ +-+-+ + + +-+ + +-+-+-+ +-+-+ + + + +-+ +
|   |   |           | |   |       |       |   | | | |     | |   |   |     |   |   | |     | | | |   |
+-+ +-+-+-+ +-+-+-+ + + +-+-+-+-+-+-+-+-+ +-+-+ + + +-+-+ + +-+ +-+ +-+-+ +-+ + +-+ + +-+-+ + + +-+-+
|     |   | |       | |       |     |     |   | | |   |   | |   |   | |   | | |   |   |     |   |   |
+ +-+-+ + + + +-+-+-+ + +-+-+ + +-+ +-+-+-+ + + + +-+ + +-+ + +-+ +-+ + +-+ + +-+ +-+-+ +-+-+-+-+ + +
|       | | |         |   | | |   | |   |   | | | |   | |   |   |     |       | |           |     | |
+ +-+-+-+ + +-+-+ + +-+-+ + + +-+-+ + + + +-+ + +-+ +-+ + + +-+ +-+-+ +-+-+ +-+ +-+-+-+-+-+ + + +-+ +
| | |     |     | |       | | |   |   |   | |       | |   |   |       |   | |     |   |   |   | |   |
+ + + +-+-+-+-+ + +-+-+-+-+ + + + + +-+-+-+ +-+ + +-+ +-+-+-+-+-+ +-+ + + + +-+ + + +-+ + +-+-+ + +-+
|   |           |           |   |         |     |   |             |     |       | |     |       |   E
+-+-+-+-+-+-+-+-+-+-+-+-+-+-+-+-+-+-+-+-+-+-+-+-+-+-+-+-+-+-+-+-+-+-+-+-+-+-+-+-+-+-+-+-+-+-+-+-+-+-+